//1,2,3,4,5,6,7,8,9,10,11,10,13,14,15,16,17,18,19,20,21,22,23,24,25,26,27,28,29,30,31,32,33,34,35,36,37,38,39,40
100,100,100,100,100,100,100,100,100,100,100,100,100,100,100,100,100,100,100,100,100,100,100,100,100,100,100,100,100,100,100,100,100,100,100,100,100,100,100,100
100,100,100,100,100,100,100,100,100,100,100,100,100,100,100,100,100,100,100,100,100,100,100,100,100,100,100,100,100,99,99,100,100,100,100,100,100,100,100,100
100,100,100,100,100,100,100,100,100,100,100,100,100,100,100,100,100,100,100,100,100,100,100,100,100,100,100,100,100,99,99,100,100,100,100,100,100,100,100,100
100,100,100,100,100,100,100,100,100,100,100,100,100,100,100,100,100,100,100,100,100,100,100,100,100,100,100,100,100,0,0,100,100,100,100,100,100,100,100,100
100,100,100,100,100,100,100,100,100,100,100,100,100,100,100,100,100,100,100,100,100,100,100,100,100,100,100,100,100,0,0,100,100,100,100,100,100,100,100,100
100,100,0,0,0,0,0,0,0,0,0,0,0,0,0,0,0,0,0,0,0,0,0,0,0,0,0,0,0,0,0,100,100,100,100,100,100,100,100,100
100,100,0,0,2,0,0,0,0,0,0,0,0,0,0,0,0,0,0,0,0,0,0,0,0,0,0,0,0,0,0,100,100,100,100,100,100,100,100,100
100,100,0,0,100,100,100,0,0,100,100,100,100,0,0,100,100,100,0,0,100,100,100,100,0,0,100,100,100,0,0,100,100,100,100,100,100,100,100,100
100,100,0,0,100,100,100,0,0,100,100,100,100,0,0,100,100,100,0,0,100,100,100,100,0,0,100,100,100,0,0,100,100,100,100,100,100,100,100,100
100,100,0,0,100,100,100,0,0,100,100,100,100,0,0,100,100,100,0,0,100,100,100,100,0,0,100,100,100,0,0,100,100,100,100,100,100,100,100,100
100,100,0,0,100,100,100,0,0,0,0,0,0,0,0,0,0,0,0,0,0,0,0,0,0,0,100,100,100,0,0,100,100,100,100,100,100,100,100,100
100,100,0,0,100,100,100,0,0,0,0,0,0,0,0,0,400,0,0,0,0,0,0,0,0,0,100,100,100,0,0,100,100,100,100,100,100,100,100,100
100,100,0,0,100,100,100,0,0,100,100,100,100,0,0,100,100,100,0,0,100,100,100,100,0,0,100,100,100,0,0,100,100,100,100,100,100,100,100,100
100,100,0,0,100,100,100,0,0,100,100,100,100,0,0,100,100,100,0,0,100,100,100,100,0,0,100,100,100,300,0,100,100,100,100,100,100,100,100,100
100,100,0,0,100,100,100,0,0,100,100,100,100,0,0,100,100,100,0,0,100,100,100,100,0,0,100,100,100,0,0,100,100,100,100,100,100,100,100,100
100,100,0,0,100,100,100,0,0,100,100,100,100,0,0,100,100,100,0,0,100,100,100,100,0,0,100,100,100,0,0,100,100,100,100,100,100,100,100,100
100,0,0,0,0,0,0,0,0,0,0,0,0,0,0,0,0,0,0,0,0,0,0,0,0,0,0,0,0,0,0,100,100,100,100,100,100,100,100,100
100,200,0,0,0,0,0,0,0,0,0,0,0,0,0,0,0,0,0,0,0,0,0,0,0,0,0,0,0,0,0,100,100,100,100,100,100,100,100,100
100,100,100,100,100,100,100,100,100,100,100,100,100,100,100,100,100,100,100,100,100,100,100,100,100,100,100,100,100,100,100,100,100,100,100,100,100,100,100,100
100,100,100,100,100,100,100,100,100,100,100,100,100,100,100,100,100,100,100,100,100,100,100,100,100,100,100,100,100,100,100,100,100,100,100,100,100,100,100,100
100,100,100,100,100,100,100,100,100,100,100,100,100,100,100,100,100,100,100,100,100,100,100,100,100,100,100,100,100,100,100,100,100,100,100,100,100,100,100,100
100,100,100,100,100,100,100,100,100,100,100,100,100,100,100,100,100,100,100,100,100,100,100,100,100,100,100,100,100,100,100,100,100,100,100,100,100,100,100,100
100,100,100,100,100,100,100,100,100,100,100,100,100,100,100,100,100,100,100,100,100,100,100,100,100,100,100,100,100,100,100,100,100,100,100,100,100,100,100,100
100,100,100,100,100,100,100,100,100,100,100,100,100,100,100,100,100,100,100,100,100,100,100,100,100,100,100,100,100,100,100,100,100,100,100,100,100,100,100,100
100,100,100,100,100,100,100,100,100,100,100,100,100,100,100,100,100,100,100,100,100,100,100,100,100,100,100,100,100,100,100,100,100,100,100,100,100,100,100,100
100,100,100,100,100,100,100,100,100,100,100,100,100,100,100,100,100,100,100,100,100,100,100,100,100,100,100,100,100,100,100,100,100,100,100,100,100,100,100,100
100,100,100,100,100,100,100,100,100,100,100,100,100,100,100,100,100,100,100,100,100,100,100,100,100,100,100,100,100,100,100,100,100,100,100,100,100,100,100,100
100,100,100,100,100,100,100,100,100,100,100,100,100,100,100,100,100,100,100,100,100,100,100,100,100,100,100,100,100,100,100,100,100,100,100,100,100,100,100,100
100,100,100,100,100,100,100,100,100,100,100,100,100,100,100,100,100,100,100,100,100,100,100,100,100,100,100,100,100,100,100,100,100,100,100,100,100,100,100,100
100,100,100,100,100,100,100,100,100,100,100,100,100,100,100,100,100,100,100,100,100,100,100,100,100,100,100,100,100,100,100,100,100,100,100,100,100,100,100,100
//1,0,3,4,5,6,7,8,9,10,11,10,13,14,15,16,17,18,19,0,1,0,3,4,5,6,7,8,9,30,31,30
100,100,100,100,100,100,100,100,100,100,100,100,100,100,100,100,100,100,100,100,100,100,100,100,100,100,100,100,100,100,100,100
100,100,100,100,100,100,100,100,100,100,100,100,100,100,100,100,100,100,100,100,100,100,100,100,100,100,100,100,100,99,99,100
100,100,100,100,100,100,100,100,100,100,100,100,100,100,100,100,100,100,100,100,100,100,100,100,100,100,100,100,100,99,99,100
100,100,100,100,100,100,100,100,100,100,100,100,100,100,100,100,100,100,100,100,100,100,100,100,100,100,100,100,100,0,0,100
100,100,100,100,100,100,100,100,100,100,100,100,100,100,100,100,100,100,100,100,100,100,100,100,100,100,100,100,100,0,0,100
100,100,0,0,0,0,0,0,0,0,0,0,0,0,0,0,0,0,0,0,0,0,0,0,0,0,0,0,0,0,0,100
100,100,0,0,2,0,0,0,0,0,4,0,0,0,0,0,0,0,0,0,0,0,0,0,0,0,0,0,0,0,0,100
100,100,0,0,100,100,100,0,0,100,100,100,100,0,0,100,100,100,0,0,100,100,100,100,0,0,100,100,100,0,0,100
100,100,0,0,100,100,100,0,0,100,100,100,100,0,0,100,100,100,0,0,100,100,100,100,0,0,100,100,100,0,0,100
100,100,0,0,100,100,100,0,0,100,100,100,100,0,0,100,100,100,0,0,100,100,100,100,0,0,100,100,100,0,0,100
100,100,0,0,100,100,100,0,0,0,0,0,0,0,0,0,0,0,0,0,0,0,0,0,0,0,100,100,100,0,0,100
100,100,0,0,100,100,100,0,0,0,0,0,0,0,0,0,400,0,0,0,0,0,0,0,0,0,100,100,100,0,0,100
100,100,0,0,100,100,100,0,0,100,100,100,100,0,0,100,100,100,0,0,100,100,100,100,0,0,100,100,100,0,0,100
100,100,0,0,100,100,100,0,0,100,100,100,100,0,0,100,100,100,0,0,100,100,100,100,0,0,100,100,100,300,0,100
100,100,0,0,100,100,100,0,0,100,100,100,100,0,0,100,100,100,0,0,100,100,100,100,0,0,100,100,100,0,0,100
100,100,0,0,100,100,100,0,0,100,100,100,100,0,0,100,100,100,0,0,100,100,100,100,0,0,100,100,100,0,0,100
100,0,0,0,0,0,0,0,0,0,0,0,0,0,0,0,0,0,0,0,0,0,0,0,0,0,0,0,0,0,0,100
100,200,0,0,0,0,0,0,0,0,0,0,0,0,0,0,0,0,0,0,0,0,0,0,0,0,0,0,0,0,0,100
100,100,100,100,100,100,100,100,100,100,100,100,100,100,100,100,100,100,100,100,100,100,100,100,100,100,100,100,100,100,100,100
100,100,100,100,100,100,100,100,100,100,100,100,100,100,100,100,100,100,100,100,100,100,100,100,100,100,100,100,100,100,100,100
100,100,100,100,100,100,100,100,100,100,100,100,100,100,100,100,100,100,100,100,100,100,100,100,100,100,100,100,100,100,100,100
100,100,100,100,100,100,100,100,100,100,100,100,100,100,100,100,100,100,100,100,100,100,100,100,100,100,100,100,100,100,100,100
100,100,100,100,100,100,100,100,100,100,100,100,100,100,100,100,100,100,100,100,100,100,100,100,100,100,100,100,100,100,100,100
100,100,100,100,100,100,100,100,100,100,100,100,100,100,100,100,100,100,100,100,100,100,100,100,100,100,100,100,100,100,100,100
